13
B,T
E,E,E,E,E,F,F,E,E,E,E,E
E,F,F,F,E,F,F,F,F,E,F,E
E,F,E,F,E,F,E,E,F,E,F,E
F,F,E,F,E,F,F,E,F,E,F,F
E,F,E,F,E,E,F,E,F,E,F,E
E,F,E,F,F,F,F,E,F,F,F,E
E,E,E,E,E,F,F,E,E,E,E,E