10
L,R,T
F,F,F,F,F,F,F,F,F,F,F,F
F,W,W,F,F,F,F,F,F,W,W,F
F,F,F,F,F,F,F,F,F,F,F,F
F,F,F,F,F,W,W,F,F,F,F,F
F,F,F,F,F,F,F,F,F,F,F,F
F,W,W,F,F,F,F,F,F,W,W,F
F,F,F,F,F,F,F,F,F,F,F,F